sampe = sampai
kya = seperti
koar-koar = membesar-besarkan
mak = ibu
sanah = sana
pa = pak
prbwo = prabowo
mnurut = menurut
jng = jangan
orng = orang 
keliatan = kelihatan
kocak = lucu
basamallah = bismillah
bkl = akan
kg = tidak
duit = uang
buat = untuk
krn = karena
trll = terlalu
gampang = mudah 
minjem = minjam 
alhasil = hasilnya
kyk = seperti
kasian = kasihan
ngeliat = melihat
bentar = sedikit
lg = lagi
fb = facebook
ga tau =tidak tahu
kek =  seperti
jngan = jangan
omon = omong
gaspol = tancap gas
moga =  semoga
blunder = keteledoran
kenceng = kencang
uga = juga
peratiin = perhatiin
revolu = revolus
yt = youtube
dr = dari
dng = dengan
yg = yang


jg = juga
byk = banyak
password = kata sandi
blh = boleh
mantab = mantap
jgn = jangan
tlg = tolong
lg = lagi
cuma = hanya
thdp = terhadap
krn = karena
tp = tapi
pdhl = padahal 
bkn = bukan
judol = judi online
pinjol = pinjaman online
bs = bisa
hack = retas
hacker = peretas
download = unduh
expert = ahli
gaptek = tidak terampil dalam teknologi
mentri = menteri
percuma = sia-sia
dicecer = dicecar
sk = suka
kudu = harus 
nama = namanya
sblm = sebelumnya
Sdm= sumber daya manusia 
Jbt = menjabat
Sniper = pembidik
Mbk = Bu
Go-blok = bodoh
Bpk = bapak
Thn  = tahun 
thun = tahun 
Jdi = menjadi
jd = menjadi
Kuy = mari
Klau = kalau
Nyinyir = menghina
Glow up = berubah menjadi lebih baik
Ttg = tentang 
Gwe = saya
ane = saya


Kawaii = lucu
Omon = omong kosong 
Unlike = tidak suka
Apk = aplikasi 
Aja = saja
aj = saja
Tar = nanti
ntar = nanti
Tivi = televisi 
Enggak  = tidak
gak = tidak
kagak = tidak
nggak = tidak
gk = tidak
ga = tidak
Agak = sedikit
Skil = keahlian
Cuy = kawan
E-library = perpustakaan digital 
Deathmeme  = meme yang tidak lucu 
Cmiiw = koreksi jika saya salah
Wait = tunggu
Request = permintaan 
Guys = teman teman 
Second = kedua
Finally = akhirnya 
Woman = wanita
Bobrok = buruk
At least = setidaknya
YTTA, yattta = yang tahu-tahu saja
A.K.A = alias
Hmmmmm = hm
tuntassssss = tuntas
serangan² = serangan-serangan
KEmenteriAN = kementerian 
BINATANG = binatang
tu = itu
support = mendukung
denger = dengar
NKRI = negara kesatuan republik indonesia
evo = evolusi
apa2 = apa-apa
Huraaay = hore
buka2an = buka-bukaan
Iklan² =iklan-iklan
ortu = orang tua
opunk = kakek
we = kita
waiting = tunggu
specialy = khususnya
plg = paling
dll = dan lain-lain
kpn = kapan
PLEASEEE = tolong
mna = mana
lbh = lebih
cb = coba
tggu = tunggu
gebrakan = gerakan
Kbeh2 ape di busek kakean pola = semua dihabiskan terlalu banyak gaya
let's go = ayo
teman" = teman-teman
koprasi = koperasi
ngasi = memberi
ngerti = paham
atw = atau
emg = emang
uninstall = hapus
netizen = warga internet
ntar = nanti
bgt = banget
prmsahkn = permasalahkan
purba = dari zaman kuno
tua bangka = orang tua
gacor = keren
vangke : bangke
mantappp : mantap
pke : pake
krna, karna : karena
kmren : kemarin
mknya : makanya
skrng : sekarang
gnti : ganti
nma : nama
dpr : dewan perwakilan rakyat
gesssss : teman teman
gk : gak
noooo ; tidak
TECHNOLOGY : teknologi
anjg : anjing
pengang : pegang
SDM : sumber daya manusia
soory : maaf
to : untuk
say : mengatakan
gen : generasi
mntn : mantan
gua : saya
mangat : semangat
wktu : waktu
mntp : mantap
hp : handphone
samaoga ; semoga
msuk : masuk
bner : bener
dripda ; dari pada
sudh ; sudah
ad : ada
trserah ; terserah
mo : mau
gnti : ganti
ato : atau
pnting : penting
jgan : jangan
kbwa : terbawa
amp : sampai
wa : whatsapp
ga : tidak
ttip ; titip
mksh : makasih
lbh : lebih
hrs : harus
dgn : dengan
ttg : tentang
jg : juga